---,2S5,2P6,2S6,2P7,2S7,2P8
---,---,---,2P5,---,---,---
---,---,---,2S4,---,---,---
---,---,---,SP4,---,---,---
---,2S1,2P2,2S2,2P3,2S3,2MA
---,2P1,---,2ME,---,---,---
*2P0,2S0,---,---,---,---,---
---,2MF,---,---,---,---,---